5
6
######
#@   #
# $  #
#  . #
######
